alias vp='vim ~/.profile'
alias ep='. ~/.profile'

alias rmnode='rm -rf node_modules'
alias yi='yarn install'
alias ys='yarn start'
alias ni='npm install'
alias nt50='npm t -- --maxWorkers=50%'

alias grs='git restore --staged'
alias grt='git restore'
alias gcp='git cherry-pick'
alias gm='git merge'
alias gmc='git merge --continue'
alias gma='git merge --abort'
alias gd='git diff'
alias gr='git rebase -i'
alias gl='git log --oneline'
alias g='git'
alias gf='git fetch'
alias gpf='git push --force-with-lease'
alias gpt='git push --tags'
alias gpl='git pull'
alias gpo='git push -u origin'
alias gp='git push'
alias gch='git checkout'
alias gchd='git checkout develop'
alias gcae='git commit --amend'
alias gca='git commit --amend --no-edit'
alias gc='git commit'
alias gcm='git commit -m'
alias ga='git add'
alias gap='git add --patch'
alias gs='git status'
alias guc='git add .; gca; gpf'
